15 = width
15 = height
333333333333333
30x300000000003
3033**330033003
303344330033303
3000000000004*3
3003344333304*3
300300003330333
300334433000003
30000*033000003
333334433003303
30000***3003303
30033***3003003
300333333004*03
3*00000000040*3
333333333333333