10
10
2222222222
2000000002
20x0000*02
2222002222
22220*2222
2000000002
2022224402
2022240*02
20*0040002
2222222222