6 = width
6 = height
111111
1*11*1
101101
100001
10x001
111111
